#############
#...B...B...#
###.#.#.#D###
  #A#C#C#A#
  #########
