#############
#...B.......#
###.#.#B#D###
  #A#.#C#A#
  #########
